NO ./n.xpm
SO ./s.xpm
WE ./w.xpm
EA ./e.xpm
F 100,0,100
C 0,100,100

1111111111
N000000001
1000000001
1000000001
1111111111
