NO ./n.xpm
SO ./s.xpm
WE ./w.xpm
EA ./e.xpm
F 100,100,100
C 200,200,200

11111111111111
10000000000001
10000000000001
10000000000001
11111111111111
