NO ./n.xpm
SO ./s.xpm
WE ./w.xpm
EA ./e.xpm
F 100,100,100
C 200,200,200

11111111111
10000000001
10S00000000
10000000000
11111111111
