NO ./textures/wall_north.xpm
SO ./textures/wall_south.xpm
WE ./textures/wall_west.xpm
EA ./textures/wall_east.xpm
F 220,100,0
C 30,200,255

111111111111111
100000000000001
100000000000001
100001110000001
100001N10000001
100001110000001
100000000000001
111111111111111
