NO ./n.xpm
SO ./s.xpm
WE ./w.xpm
EA ./e.xpm
F 123,45,67
C 89,210,123

     11111    
     10001    
     10N01    
     10001    
     11111    
