NO ./n.xpm
SO ./s.xpm
WE ./w.xpm
EA ./e.xpm
F 200,100,50
C 0,255,255

1111111111111
1N00000000001
1000011100001
100001 100001
1000011100001
1000000000001
1111111111111
