NO ./n.xpm
SO ./s.xpm
WE ./w.xpm
EA ./e.xpm
F 0,0,0
C 255,255,255

1111111111
1000000A01
1000000001
1000000N01
1111111111
