NO ./n.xpm
SO ./s.xpm
WE ./w.xpm
EA ./e.xpm
F 0,0,0
C 255,255,255

1111111111
10000N0001
10N0000001
1111111111

