NO ./n.xpm
SO ./s.xpm

11111
10N01
10001

WE ./w.xpm
EA ./e.xpm
F 200,0,0
C 0,0,255
11111
