NO ./n.xpm
SO ./s.xpm
WE ./w.xpm
EA ./e.xpm
F 123,123,123
C 100,100,100

111111111
1000©0001
1000N0001
10000¥001
111111111
