NO ./n.xpm
SO ./s.xpm
WE ./w.xpm
EA ./e.xpm
F 200,200,200
C 10,10,10

11111111@@
10000001@@
10000N01@@
10000001@@
11111111@@
