NO ./n.xpm
SO ./s.xpm
WE ./w.xpm
EA ./e.xpm
F 100,200,100
C 200,100,200

1111111111

1000000001

10000N0001

1000000001

1111111111
