NO ./n.xpm
SO ./s.xpm
WE ./w.xpm
EA ./e.xpm
F 0,100,200
C 100,0,0

11111
10	001
10N01
10001
11111
