NO ./n.xpm
SO ./s.xpm
WE ./w.xpm
EA ./e.xpm
F 255,255,255
C 0,0,0







11111111111111
10000000000001
100000000E0001
10000000000001
11111111111111
