NO ./textures/cat1.xpm
SO ./textures/cat3.xpm
WE ./textures/cat4.xpm
EA ./textures/cat2.xpm
F 87,60,30
C 0,0,0


      111111
      110001
      110001
      110001
      110001
      110001
      110001
      110001 
      110001
11111110000011 
10110000000001
1E000000000001
10110000000001
11111111111111
