NO ./n.xpm
SO ./s.xpm
WE ./w.xpm
EA ./e.xpm
F 50,50,50
C 150,150,150

11111
100001
1000001
10000001
100000001
1000000001
1000N000001
1000000001
100000001
10000001
1000001
100001
11111
