NO ./textures/cat1.xpm
SO ./textures/cat3.xpm
WE ./textures/cat4.xpm
EA ./textures/cat2.xpm


      111111
      110001
      110001
      110001
      110001
      110001
      110001
      110001 
      111D11
11111110000011 
10110000000001
10000000000001
10110000N00001
11111111111111
