NO ./textures/cat1.xpm
SO ./textures/cat3.xpm
WE ./textures/cat4.xpm
EA ./textures/cat2.xpm
F 87,60,30
C 0,0,0

      111111
      11C001
      110001
      110001
      110001
      110001
      110001
      110001 
      110C01
11111110000011 
1C11000000C001
100C0000000001
1C110000N000C1
11111111111111
