NO ./n.xpm
SO ./s.xpm
WE ./w.xpm
EA ./e.xpm
F 255,255,255
C 0,0,0

11111
10😀01
10N01
10001
11111
