NO ./n.xpm
SO ./s.xpm
WE ./w.xpm
EA ./e.xpm
F 123,123,123
C 200,200,200

11111111100001100N01100011111111111
