NO ./n.xpm
SO ./s.xpm
WE ./w.xpm
EA ./e.xpm
F 0,0,0
C 255,255,255

1111111111
1000000001
10000 0 N1
1000000001
1111111111
