
11111
10N01
10001
10001
11111
